1111111111111111111111111111111111
1E000000TTTTTEEC0000C0000000000011
1010010100100000101001000000010101
101P010010101010001001000000010101
1P0P00000C00C0000000000000000000C1
1111111111111111111111111111111111
