111111111111111111111111111111111111111111111111111111111111
10010010000000C0000000000000000000000000C0000000000000000001
1001000010000000C00000000000000000000000C0000000000000000001
10010010000000C0000000000000000000000000C0000000000000000001
100100010000000C000000000000000000000000C0000000000000000001
10010010000000C0000000000000000000000000C0000000000000000001
10010010000000C0000000000000000000000000C0000000000000000001
10010010000000C0000000000000000000000000C0000000000000000001
10010010000000C0000000000000000000000000C0000000000000000001
10010010000000C0000000000000000000000000C0000000000000000001
10010010000000C0000000000000000000000000C0000000000000000001
10010010000000C0000000000000000000000000C0000000000000000001
10010010000000C0000000000000000000000000C0000000000000000001
10010010000000C0000000000000000000000000C0000000000000000001
10000000000000C0000000000000000000000000C0000000000000000001
10000000000000C0000000000000000000000000C0000000000000000001
10010010000000C0000000000000000000000000C0000000000000000001
10010010000000C0000000000000000000000000C0000000000000000001
10010010000000C0000000000000000000000000C0000000000000000001
10010010000000C0000000000000000000000000C0000000000000000001
10010010000000C0000000000000000000000000C0000000000000000001
10010010000000C0000000000000000000000000C0000000000000000001
10010010000000C0000000000000000000000000C0000000000000000001
10010010000000C0000000000000000000000000C0000000000000000001
10010010000000C0000000000000000000000000C0000000000000000001
10010010000000C0000000000000000000000000C0000000000000000001
10010010000000C0000000000000000000000000C0000000000000000001
10010010000000C0000000000000000000000000C0000000000000000001
10010010000000C0000000000000000000000000C0000000000000000001
10010010000000C0000000000000000000000000C0000000000000000001
1PE10010000000C0000000000000000000000000C0000000000000000001
10010010000000C0000000000000000000000000C0000000000000000001
111111111111111111111111111111111111111111111111111111111111
