1111111111111111111111111111111
10010000000C0000000000000000001
10010000000C0000000000000000001
10010000000C0000000000000000001
10010000000C0000000000000000001
10010000000C0000000000000000001
10010000000C0000000000000000001
10010000000C0000000000000000001
10010000000C0000000000000000001
10010000000C0000000000000000001
10010000000C0000000000000000001
10010000000C0000000000000000001
10010000000C0000000000000000001
10010000000C0000000000000000001
10010000000C0000000000000000001
10010000000C0000000000000000001
10010000000C0000000000000000001
10010000000C0000000000000000001
10010000000C0000000000000000001
10010000000C0000000000000000001
10010000000C0000000000000000001
10010000000C0000000000000000001
10010000000C0000000000000000001
10010000000C0000000000000000001
10010000000C0000000000000000001
10010000000C0000000000000000001
10010000000C0000000000000000001
10010000000C0000000000000000001
10010000000C0000000000000000001
10010000000C0000000000000000001
1PE10000000C0000000000000000001
1111111111111111111111111111111
