11111111111
1ECPCCCCCC1
10000000001
10000000001
10000000001
10000000001
11111111111
